000000000000000000000000000000000000000000000000000000000000000000000000000000000000000000000000
120000000000000000000000000000000000000000000000000000000000000000000000000000000000000000000000
000000000000000000000000000000000000000000000000000000000000000000000000000000000000000000000000
000000000000000000000000000000000000000000000000000000000000000000000000000000000000000000000000
000000000000000000000000000000000000000000000000000000000000000000000000000000000000000000000000
000000000000000000000000000000000000000000000000000000000000000000000000000000000000000000000000
000000000000000000000000000000000000000000000000000000000000000000000000000000000000000000000000
000000000000000000000000000000000000000000000000000000000000000000000000000000000000000000000000
000000000000000000000000000000000000000000000000000000000000000000000000000000000000000000000000
000000000000000000000000000000000000000000000000000000000000000000000000000000000000000000000000
000000000000000000000000000000000000000000000000000000000000000000000000000000000000000000000000
000000000000000000000000000000000000000000000000000000000000000000000000000000000000000000000000
000000000000000000000000000000000000000000000000000000000000000000000000000000000000000000000000
000000000000000000000000000000000000000000000000000000000000000000000000000000000000000000000000
000000000000000000000000000000000000000000000000000000000000000000000000000000000000000000000000
000000000000000000000000000000000000000000000000000000000000000000000000000000000000000000000000
000000000000000000000000000000000000000000000000000000000000000000000000000000000000000000000000
000000000000000000000000000000000000000000000000000000000000000000000000000000000000000000000000
000000000000000000000000000000000000000000000000000000000000000000000000000000000000000000000000
000000000000000000000000000000000000000000000000000000000000000000000000000000000000000000000000
000000000000000000000000000000000000000000000000000000000000000000000000000000000000000000000000
000000000000000000000000000000000000000000000000000000000000000000000000000000000000000000000000
000000000000000000000000000000000000000000000000000000000000000000000000000000000000000000000000
000000000000000000000000000000000000000000000000000000000000000000000000000000000000000000000000
000000000000000000000000000000000000000000000000000000000000000000000000000000000000000000000000
000000000000000000000000000000000000000000000000000000000000000000000000000000000000000000000000
000000000000000000000000000000000000000000000000000000000000000000000000000000000000000000000000
000000000000000000000000000000002600000000000000000000000000000000000000000000000000000000000000
000000000000000000000000000006662600001000000006000000000101110000000000000000000000000000000000
000000000000000000000000000066262662612000121066066660000111210010000000000000000000000000000000
000000000000000000000000000066666666111000126666006661000121121120000000000000000000000000000000
000000000000000000000000000006266262111111121262266662122111111100000000000000000000000000000000
000000000000000000000000000006666266111121111626666661111111112100000000000000000000000000000000
000000000000000000000000000060662666212121111626666661166611112110000000000000000000000000000000
000000000000000000000000000066666666611211111666262626616661111121200000000000000000000000000000
000000000000000000000000000006666611211111112666626666612661211111100000000000000000000000000000
000000000000000000000000000006666626621111211662662621122666612111110000000000000000000000000000
000000000000000000000000000006666266621211116666262611116666662111000000000000000000000000000000
000000000000000000000000000006666266621112116666222666266666662266000000000000000000000000000000
000000000000000000000000000666666266621112116226666621166666266662000000000000000000000000000000
000000000000000000000000000006626616112121112622666666166666666112100000000000000000000000000000
000000000000000000000000000000666666122211266266266661166666666112000000000000000000000000000000
000000000000000000000000000001111161112626266666666661166666611201000000000000000000000000000000
000000000000000000000000000000121111661166222666216622166666621211000000000000000000000000000000
000000000000000000000000000011111111661166662666616611216666666111000000000000000000000000000000
000000000000000000000000000011111112162666666266661221126666661110000000000000000000000000000000
000000000000000000000000000000211166662666662222161112116626661122000000000000000000000000000000
000000000000000000000000000001221112626621166266111111126266111100000000000000000000000000000000
000000000000000000000000000021112121112666166626111111112111111120000000000000000000000000000000
000000000000000000000000000000212211166666622611222121111111111110000000000000000000000000000000
000000000000000000000000000000211112116666621121211121111211112110000000000000000000000000000000
000000000000000000000000000011121111211666221111121121111111212101000000000000000000000000000000
000000000000000000000000000000111111111666122111111222111111211111120000000000000000000000000000
000000000000000000000000000000121221111166111111122211111111111111100000000000000000000000000000
000000000000000000000000000001111121111112211211211111211111111111000000000000000000000000000000
000000000000000000000000000000111211112212221111112211111112111111000000000000000000000000000000
000000000000000000000000000000111111121211111111111121111111111122200000000000000000000000000000
000000000000000000000000000000011211111111221122211111211221111111100000000000000000000000000000
000000000000000000000000000000122111111121112112111111212111121110000000000000000000000000000000
000000000000000000000000000011121211112211121111211111111212211110000000000000000000000000000000
000000000000000000000000000001012111211111222121122111121111111211000000000000000000000000000000
000000000000000000000000000011022111211111111121211121111122111211100000000000000000000000000000
000000000000000000000000000011111122112111121211111111111111111111100000000000000000000000000000
000000000000000000000000000000011121112111111111121111111211222211000000000000000000000000000000
000000000000000000000000000000001011211111211121102111021121212120000000000000000000000000000000
000000000000000000000000000000000011211110012112101000001211001110000000000000000000000000000000
000000000000000000000000000000000002000100000110000000000010000210000000000000000000000000000000
000000000000000000000000000000000000000100000000000000000000000010000000000000000000000000000000
000000000000000000000000000000000000000000000000000000000000000000000000000000000000000000000000
000000000000000000000000000000000000000000000000000000000000000000000000000000000000000000000000
000000000000000000000000000000000000000000000000000000000000000000000000000000000000000000000000
000000000000000000000000000000000000000000000000000000000000000000000000000000000000000000000000
000000000000000000000000000000000000000000000000000000000000000000000000000000000000000000000000
000000000000000000000000000000000000000000000000000000000000000000000000000000000000000000000000
000000000000000000000000000000000000000000000000000000000000000000000000000000000000000000000000
000000000000000000000000000000000000000000000000000000000000000000000000000000000000000000000000
000000000000000000000000000000000000000000000000000000000000000000000000000000000000000000000000
000000000000000000000000000000000000000000000000000000000000000000000000000000000000000000000000
000000000000000000000000000000000000000000000000000000000000000000000000000000000000000000000000
000000000000000000000000000000000000000000000000000000000000000000000000000000000000000000000000
000000000000000000000000000000000000000000000000000000000000000000000000000000000000000000000000
000000000000000000000000000000000000000000000000000000000000000000000000000000000000000000000000
000000000000000000000000000000000000000000000000000000000000000000000000000000000000000000000000
000000000000000000000000000000000000000000000000000000000000000000000000000000000000000000000000
000000000000000000000000000000000000000000000000000000000000000000000000000000000000000000000000
000000000000000000000000000000000000000000000000000000000000000000000000000000000000000000000000
000000000000000000000000000000000000000000000000000000000000000000000000000000000000000000000000
000000000000000000000000000000000000000000000000000000000000000000000000000000000000000000000000
000000000000000000000000000000000000000000000000000000000000000000000000000000000000000000000000
000000000000000000000000000000000000000000000000000000000000000000000000000000000000000000000000
000000000000000000000000000000000000000000000000000000000000000000000000000000000000000000000000
000000000000000000000000000000000000000000000000000000000000000000000000000000000000000000000000
000000000000000000000000000000000000000000000000000000000000000000000000000000000000000000000000
000000000000000000000000000000000000000000000000000000000000000000000000000000000000000000000000
000000000000000000000000000000000000000000000000000000000000000000000000000000000000000000000000
000000000000000000000000000000000000000000000000000000000000000000000000000000000000000000000000
